HTML 属性赋予元素意义和语境。

下面的全局属性可用于任何 HTML 元素。

HTML 全局属性
= HTML5 中添加的属性。

属性	描述
accesskey	规定激活元素的快捷键。
class	规定元素的一个或多个类名（引用样式表中的类）。
contenteditable	规定元素内容是否可编辑。
contextmenu	规定元素的上下文菜单。上下文菜单在用户点击元素时显示。
data-*	用于存储页面或应用程序的私有定制数据。
dir	规定元素中内容的文本方向。
draggable	规定元素是否可拖动。
dropzone	规定在拖动被拖动数据时是否进行复制、移动或链接。
hidden	规定元素仍未或不再相关。
id	规定元素的唯一 id。
lang	规定元素内容的语言。
spellcheck	规定是否对元素进行拼写和语法检查。
style	规定元素的行内 CSS 样式。
tabindex	规定元素的 tab 键次序。
title	规定有关元素的额外信息。
translate	规定是否应该翻译元素内容。
